11111111111111111111111111
1P011000100000001100100001
10100111000011100111E01111
10101100001111000000000111
10111000000011100C01111111
10100001110101110000111001
10000011110010000000000001
11111111111111111111111111