11111111111111111111111111
1P001000100C00001100000001
10000111000011100110E01111
1000110C00111100C00C000111
10011000000011100001111111
1010C0011100C1110000111001
100000111100000000C0000001
11111111111111111111111111