111111111111111111111111111111111111111
1P0000001001010001000000001100000000011
111000111001110100000010110111000111111
100000001001010001000000001100000000011
111000111001110100000010110111000111111
101000000010000011111111111010000000001
100000000000000000100000C00000000000111
100000001001010001000000001100000000011
111000111001110100000010110111000111111
100000001001010001000EC00011000000C0011
1110001110011101000C0010110111000111111
111111111111111111111111111111111111111